###################
#        B        #
#                 #
#                 #
#                 #
#                 #
#                 #
#                 #
#                 #
#        A        #
###################